111111111111111111111111111111111111111111111111111111111111
10000000000000CC00011111000000000000000000000CC0000000000001
100000000000000000000000000000000000000000000000000000000001
10000000000000000000001111111100000000000000011CC00000000111
100000000000000000000011111111000000000000000000000000000011
1000000000CCP00000000000000000000000E00000000000000000000001
100000000000000000000000000000000000000000111111000000000001
100000000000000000000000000000000000000000000000000000000001
100000C0000C00000000011111110000000000100000000000CC00000001
100000000000000000000000000000000000000000000000000000000001
111111111111111111111111111111111111111111111111111111111111
