111111111111111111111111
1C00000000C000000CCC1111
10100101P0000000001C00C1
101001001010100011111111
1CCCC1000000000010C00001
111111000011000000011111
1111111111111100E0000001
111111111111111111111111