1111111111111111111
1P00C10000E0C000001
1010000010101000111
10000100C0000000001
1111111111111111111
