1111111111111
10010000C0C11
1000000111111
1P000000E0001
1111111111111
