1111111111111111111
1P0000000000C000001
1010010100000000001
1010010010101000111
100000000000000E001
1111111111111111111
