111111111111111111111111
1C00000000C000000CCC1111
10100101P0000000001C00C1
101001001010100011111111
1CCCC100000000000EC00001
111111000011001111011111
111111111111100111111111
1C0000000000000000000001
111111111111111111111111
