11111111111111111111111111
1000000000000000000P000001
11111CC000000E110000000001
10000000000000000000000001
100000000000E0000000000001
11111111111111111111111111
