1111111111111111
10000CC0000E0001
111000000P000001
1000000000000001
1000000P00000001
1111111111111111
