1111111111
10000P0001
1000E00001
1111111111
