11111111111
10000000C11
11100E11111
11111111111
